####################
#..........#Q......#
#.######.###.#####.#
#.#>...#.........#.#
#.#.#.#.#########..#
#.#.#.#.#.........##
#.#.#.#.#.#####.####
#.#.#.#.#.#.#......#
#.#.#.#.#.#.##.#####
#.#.#.#.#.#........#
###.#.#.#.##########
#.....#.#..........#
#.#####.##########.#
#.#.....#........#.#
#.#.#####.######.#.#
#.#...........#..#.#
#.###########.#.##.#
#.............#....#
#.##################
#..................#
####################
